"filename", "language", "Markdown", "C++", "Docker", "CUDA C++", "comment", "blank", "total"
"d:\Github\ml-library\Dockerfile", "Docker", 0, 0, 17, 0, 24, 10, 51
"d:\Github\ml-library\README.md", "Markdown", 7, 0, 0, 0, 0, 1, 8
"d:\Github\ml-library\include\ml_framework\autograd.h", "C++", 0, 0, 0, 0, 1, 1, 2
"d:\Github\ml-library\include\ml_framework\config.h", "C++", 0, 68, 0, 0, 9, 10, 87
"d:\Github\ml-library\include\ml_framework\linear.h", "C++", 0, 23, 0, 0, 4, 4, 31
"d:\Github\ml-library\include\ml_framework\module.h", "C++", 0, 32, 0, 0, 4, 5, 41
"d:\Github\ml-library\include\ml_framework\mse_loss.h", "C++", 0, 4, 0, 0, 2, 0, 6
"d:\Github\ml-library\include\ml_framework\relu.h", "C++", 0, 20, 0, 0, 0, 6, 26
"d:\Github\ml-library\include\ml_framework\suppress_warnings.h", "C++", 0, 10, 0, 0, 1, 3, 14
"d:\Github\ml-library\include\ml_framework\tensor.h", "C++", 0, 56, 0, 0, 2, 11, 69
"d:\Github\ml-library\include\ml_framework\utils.h", "C++", 0, 5, 0, 0, 2, 1, 8
"d:\Github\ml-library\src\autograd.cpp", "C++", 0, 0, 0, 0, 0, 1, 1
"d:\Github\ml-library\src\kernel.cu", "CUDA C++", 0, 0, 0, 72, 10, 18, 100
"d:\Github\ml-library\src\linear.cpp", "C++", 0, 28, 0, 0, 12, 8, 48
"d:\Github\ml-library\src\module.cpp", "C++", 0, 74, 0, 0, 56, 19, 149
"d:\Github\ml-library\src\mse_loss.cpp", "C++", 0, 0, 0, 0, 0, 1, 1
"d:\Github\ml-library\src\relu.cpp", "C++", 0, 28, 0, 0, 0, 6, 34
"d:\Github\ml-library\src\tensor.cpp", "C++", 0, 273, 0, 0, 42, 49, 364
"d:\Github\ml-library\src\utils.cpp", "C++", 0, 0, 0, 0, 0, 1, 1
"d:\Github\ml-library\tests\main.cpp", "C++", 0, 7, 0, 0, 0, 1, 8
"d:\Github\ml-library\tests\test_autograd.cpp", "C++", 0, 0, 0, 0, 0, 1, 1
"d:\Github\ml-library\tests\test_module.cpp", "C++", 0, 34, 0, 0, 187, 44, 265
"d:\Github\ml-library\tests\test_tensor.cpp", "C++", 0, 170, 0, 0, 35, 43, 248
"Total", "-", 7, 832, 17, 72, 391, 244, 1563